1111111111111111111111111
10000000N00000011111111111
111111111111111111111111111