	NO ./textures/north.xpm
           SO ./textures/south.xpm
WE ./textures/west.xpm
EA 	./textures/east.xpm
EA 	./textures/east.xpm
		F	 220		 ,  100 	,0
   C 			  			225,   30,     0
   

111111111111111
111111111111111
100000000000001
1000000000000011111111111
1000000000000000000000001
10000000N00000011111111111
100000001000001
100000000000001
100000100000001111
100000000000001
100000000000001
1111111111111111
100000000000001
100000000000001
110000001000001
100000000000001
110000000000111
111111111111111
