	NO ./textures/north.xpm
           SO ./textures/south.xpm
WE ./textures/west.xpm
EA 	./textures/east.xpm


		F	 220		 ,  100 	,0
   C 			  			225,   30,     0
   
1
10
100
1000
10000
100000000000001
100000000000001   111
100000000000001   101
100000000000001   111
10000N000000001
100000000000001
100000000000001
100000000000001
100000000000001
100000000000001
100000000000001
100000000000001
110000000000111
 111111111111  
