NO ./textures/north.xpm
SO ./textures/south.xpm
WE ./textures/west.xpm
EA ./textures/east.xpm

F 20,20,20
C 200,200,200

111111111111111111111
100000000000000000001
101111111111111111101
101000000000000000101
101011111111111110101
101010000000000010101
101010111111111010101
101010100000001010101
101010101111101010101
101010101N00101010101
101010101111101010101
101010100000001010101
101010111111111010101
101010000000000010101
101011111111111110101
101000000000000000101
101111111111111111101
100000000000000000001
111111111111111111111 