F 126,126,126
C 54,69,79

111111111111
100000000001
10N000000001
100000000001
100000000001
111111111111 
