NO ./textures/TECH_1E.xpm
SO ./textures/TECH_1E.xpm
WE ./textures/TECH_2F.xpm
EA ./textures/TECH_3B.xpm

F 126,126,126
C 54,69,79

111111111111
1N0000000001
100000000001
100000S00001
100000000001
111111111111 
