NO ./textures/north.xpm
SO ./textures/south.xpm
WE ./textures/west.xpm
EA ./textures/east.xpm

F 139,69,19
C 100,149,237

1111111111111
10000000E0001
1000111000001
1000001000001
1000001000001
1000101000001
1000111000001
1000000000001
1111111111111