NO ./textures/TECH_1E.xpm
SO ./textures/TECH_1E.xpm
WE ./textures/TECH_2F.xpm
EA ./textures/TECH_3B.xpm	

F 20,20,20
C 200,200,200

111111111111111111111
100000000000000000001
101111111111111111101
101000000000000000101
101011111111111110101
101010000000000010101
101010111111111010101
101010100000001010101
101010101101101010101
101010101N00100010101
101010101111101010101
101010100000001010101
101010111111011010101
101000000000000010101
100011111111111110101
101000000000000000101
101111101111111111101
100000000000000000001
111111111111111111111 