NO ./textures/TECH_1E.xpm
SO ./textures/TECH_1E.xpm
WE ./textures/TECH_2F.xpm
EA ./textures/TECH_3B.xpm	

F 126,126,126
C 54, 69, 79

111111111111111
100010001000001
101110111011101
100000000000001
100N10001000001
101110111011101
100000000000001
100010001000001
111111111111111