NO ./textures/TECH_1E.xpm
SO ./textures/TECH_1E.xpm
WE ./textures/TECH_2F.xpm
EA ./textures/TECH_3B.xpm	

F 126,126,126
C 54, 69, 79

1111111111111
10000000E0001
1000111000001
1000001000001
1000001000001
1000101000001
1000111000001
1000000000001
1111111111111